pig animal(especially one that requires effort or boldness)
Alleviate - verb provide physical relief, as from pain; make easier
Advisor - noun an expert who gives advice
Aloof - adj. remote in manner; adv. in an aloof manner
Acerbic - adj. harsh or corrosive in tone; sour or bitter in taste
Austerity - noun the trait of great self-denial (especially refraining from worldly pleasures)
Ascertain - verb learn or discover with certainty; be careful or certain to do something; make certain of something
Argument - noun a variable in a logical or mathematical expression whose value determines the dependent variable; if f(x)=y, x is the
Amorous - adj. inclined toward or displaying love; expressive of or exciting sexual love or romance
Bibliographical - adj. relating to or dealing with bibliography
Boisterous - adj. violently agitated and turbulent; noisy and lacking in restraint or discipline
Complementary - adj. of words or propositions so related that each is the negation of the other; acting as or providing a complement
Concisely - adv. in a concise manner; in a few words
Conference - noun a discussion among participants who have an agreed (serious) topic; a prearranged meeting for consultation or
Consistent - adj. (sometimes followed by `with') in agreement or consistent or reliable; the same throughout in structure
Confession - noun (Roman Catholic Church) the act of a penitent disclosing his sinfulness before a priest in the sacrament of
Bolster - noun a pillow that is often put across a bed underneath the regular pillows; verb support and strengthen
Bogus - adj. fraudulent; having a misleading appearance
Constitution - noun the act of forming something; United States 44-gun frigate that was one of the first three naval ships built by the
Conventional - adj. following accepted customs and proprieties; unimaginative and conformist
Critical - adj. marked by a tendency to find and call attention to errors and flaws; characterized by careful evaluation and judgment
Criticism - noun a serious examination and judgment of something; a written evaluation of a work of literature
Cursory - adj. hasty and without attention to detail; not thorough
Curiosity - noun a state in which you want to learn more about something; something unusual -- perhaps worthy of collecting
Delightful - adj. greatly pleasing or entertaining
Delicious - adj. greatly pleasing or entertaining; extremely pleasing to the sense of taste
Conversation - noun the use of speech for informal exchange of views or ideas or information etc.
Contemporary - adj. belonging to the present time; characteristic of the present
Dialogue - noun a literary composition in the form of a conversation between two people; the lines spoken by characters in drama or fiction
Diffidence - noun lack of self-confidence
Effective - adj. existing in fact; not theoretical; real; able to accomplish a purpose; functioning effectively
Eccentric - adj. not having a common center; not concentric; conspicuously or grossly unconventional or unusual
Enthusiasm - noun a lively interest; a feeling of excitement
Engage - verb get caught; keep engaged
Executive - adj. having the function of carrying out plans or orders etc.; noun persons who administer the law
Exacerbate - verb exasperate or irritate; make worse
Endeavor - noun earnest and conscientious activity intended to do or accomplish something; a purposeful or industrious undertaking
Eminence - noun high status importance owing to marked superiority; a protuberance on a bone especially for attachment of a
Fanciful - adj. indulging in or influenced by fancy; having a curiously intricate quality
Fierce - adj. marked by extreme intensity of emotions or convictions; inclined to react violently; fervid; violently agitated and turbulent
Fortuitous - adj. occurring by happy chance; having no cause or apparent cause
Flexibility - noun the quality of being adaptable or variable; the property of being flexible; easily bent or shaped
Galaxy - noun a splendid assemblage (especially of famous people); (astronomy) a collection of star systems; any of the billions of
Frugality - noun prudence in avoiding waste
Innovation - noun the act of starting something for the first time; introducing something new; a creation (a new device or process)
Majesty - noun impressiveness in scale or proportion
Interest - noun the power of attracting or holding one's attention (because it is unusual or exciting etc.); a sense of concern with and
Indecorous - adj. lacking propriety and good taste in manners and conduct; not in keeping with accepted standards of what is right
Hostess - noun a woman innkeeper; a woman host
Mitigate - verb make less severe or harsh; lessen or to try to lessen the seriousness or extent of
Meticulous - adj. marked by extreme care in treatment of details; marked by precise accordance with details
Hard - adj. dried out; unfortunate or hard to bear
Normal - adj. conforming with or constituting a norm or standard or level or type or social norm; not abnormal; being approximately
Notoriety - noun the state of being known for some unfavorable act or quality
Orthodox - adj. adhering to what is commonly accepted; of or pertaining to or characteristic of Judaism
Obsolete - adj. old; no longer in use or valid or fashionable; no longer in use
Mysterious - adj. having an import not apparent to the senses nor obvious to the intelligence; beyond ordinary understanding; of an
Passionate - adj. having or expressing strong emotions
Placid - adj. (of a body of water) free from disturbance by heavy waves; living without undue worry; taking life easy
Placid - adj. (of a body of water) free from disturbance by heavy waves; living without undue worry; taking life easy
Pellucid - adj. (of language) transparently clear; easily understandable; transmitting light; able to be seen through with clarity
Prolixity - noun boring verbosity
Precarious - adj. affording no ease or reassurance; not secure; beset with difficulties
Polemical - adj. of or involving dispute or controversy
Overshadow - verb cast a shadow upon; exceed in importance; outweigh
Fresh - adj. improperly forward or bold; not yet used or soiled
Fastidious - adj. giving careful attention to detail; hard to please; excessively concerned with cleanliness; having complicated
Deteriorate - verb become worse or disintegrate; grow worse
Reference - noun the act of referring or consulting; the most direct or specific meaning of a word or expression;
Rational - adj. having its source in or being guided by the intellect (distinguished from experience or emotion); consistent with or
Research - noun systematic investigation to establish facts; a search for knowledge
Skittish - adj. unpredictably excitable (especially of horses)
Restive - adj. impatient especially under restriction or delay; being in a tense state
Stinginess - noun a lack of generosity; a general unwillingness to part with money
Sweet - adj. pleasing to the senses; (used of wines) having a high residual sugar content
Stewardess - noun a woman steward on an airplane
Temperance - noun the act of tempering; the trait of avoiding excesses
Tumultuous - adj. characterized by unrest or disorder or insubordination
United States; it won brilliant victories over British frigates during the War of 1812 and is without doubt the most famous ship in the
Typical - adj. conforming to a type; exhibiting the qualities or characteristics that identify a group or kind or category
Tolerance - noun the act of tolerating something; the power or capacity of an organism to tolerate unfavorable environmental conditions
Tasty - adj. pleasing to the sense of taste
Taciturnity - noun the trait of being uncommunicative; not volunteering anything more than necessary
Volubility - noun the quality of being facile in speech and writing
based on or using reason
curiosity about someone or something
average or within certain limits in e.g. intelligence and development
history of the United States Navy; it has been rebuilt and is anchored in the Charlestown Navy Yard in Boston
independent variable; a summary of the subject or plot of a literary work or play or movie
exchange of information or discussion (especially one with a formal agenda)
Yummy - adj. extremely pleasing to the sense of taste
Virtual - adj. existing in essence or effect though not in actual fact; being actually such in almost every respect
Prophetic - adj. foretelling events as if by supernatural intervention
muscle or ligament
resulting from study and experimentation
systems each having many stars and nebulae and dust
penance in the hope of absolution; a written document acknowledging an offense and signed by the guilty party
obscure nature
nutritional requirements; especially growing only in special artificial cultures
more people to perform an unlawful act
Conspiracy - noun a plot to carry out some harmful or illegal act (especially a political plot); a secret agreement between two or
Ameliorate - verb get better; to make better
